keystone
An Interactive Fiction by Connor McCann
Release 1 / Serial number 140313 / Inform 7 build 6G60 (I6/v6.32 lib 6/12N) SD

Keystone
You awake on a cold stone floor to the sound of doors slamming shut. You sit up, startled. The room is small, windowless, and its only sources of light are small candles, one in each corner. The light flickers softly. As you look closer at the walls, you notice each has a shadowy recess that looks vaguely like a door. North of you is the biggest recess, it looks like stone. To the south the is the smallest recess. To the east is a shimmering door that looks to be made of some kind of metal. To the west the the door is made of wood.

You can see a small door, a shimmering metallic door, a heavy stone door and an ornate wooden door here.

I beg your pardon?

I beg your pardon?

>go east
(first opening the shimmering metallic door)

Facility
The door shuts behind you and you hear a locking sound. The the room is remarkably bright, but you cannot see its source. The walls, floors, and ceiling are covered in a uniformly white, cloth-like material. In the middle of the room sits a rabbit in a cage, and next to it lies a white envelope.

You can see a shimmering metallic door, a cage (closed) and an envelope (in which are a key and a note) here.

>take key
Taken.

>go west
Keystone
You awake on a cold stone floor to the sound of doors slamming shut. You sit up, startled. The room is small, windowless, and its only sources of light are small candles, one in each corner. The light flickers softly. As you look closer at the walls, you notice each has a shadowy recess that looks vaguely like a door. North of you is the biggest recess, it looks like stone. To the south the is the smallest recess. To the east is a shimmering door that looks to be made of some kind of metal. To the west the the door is made of wood.

You can see a shimmering metallic door, a heavy stone door, an ornate wooden door and a small door here.

>unlock small door
(with the key)
You unlock the small door.

>enter small door
(first opening the small door)

Cathedral
You can see a small door here.

* * *

I beg your pardon?

>north
(first opening the heavy stone door)

The Instinct
The smell of death invades your nostrils. Frightened, you quickly scan what appears to be a cave. Straight ahead, lightning flashes and you can make out the mouth of the cave. Another flash, and you catch a glimpse of what seems to be a tiger devouring a carcass right at the entrance. You feel it shift its gaze to you. It charges straight for you and you turn to run, but the heavy stone door has shut behind you. The tiger leaps at you and you close your eyes, fearing the worst. The cave goes silent. Terrified, you open your eyes. Another flash of light, the tiger cannot be found. Another flash and crack of thunder and you can see the carcass still lies to the north at the mouth of the cave, and the blood is beginning to pool at your feet. It looks like it may be a person.

You can see a heavy stone door and a carcass here.

>carcass
That's not a verb I recognise.

>examine carcass
The man is bloodied and crumpled. He wears a shredded blazer and bloodstained pants. You lean down to feel if he is still breathing, and to your surprise, he mutters something under his breath. You lean closer. The muttering continues, and this time you can make out what he says. "…Wa--wallet."

>examine jacket
You can't see any such thing.

>examine blazer
You see nothing special about the blazer.

The blazer's pocket contains a wallet and a photograph.

>examine wallet
Can it be? The card says your name and birthdate on it.

In the wallet is an ID.

>examine ID
You see nothing special about the ID.

I beg your pardon?

>examine photograph
As you examine the photograph, lightning flashes again. It is a picture of a man with his back turned, and a large mass engulfed in flame in front of him.

* * *

>examine carcass
The man is bloodied and crumpled. He wears a shredded blazer and bloodstained pants. You lean down to feel if he is still breathing, and to your surprise, he mutters something under his breath. You lean closer. The muttering continues, and this time you can make out what he says. "…Wa--wallet.§ጐ"

>examine blazer
You see nothing special about the blazer.

The blazer's pocket contains a wallet and a photograph.

>examine wallet
In the wallet is an ID.

>examine ID
Can it be? The card says your name and birthdate on it.

>examine photograph
As you examine the photograph, lightning flashes again. It is a picture of a man with his back turned, and a large mass engulfed in flame in front of him. It has an eerie look, and feel a shiver shoot down your spine.

* * *

I beg your pardon?

>go west
(first opening the ornate wooden door)

Lincoln Room
You enter the room, and again are met with the faint glow of candle light. The floor is wooden, and there is what looks like antique furniture all around. You walk forward, and notice a dim glow out of the corner of your eye. To the West is a window, it looks like there is some kind of light source outside.

You can see a Lincoln Window and an ornate wooden door here.

>open window
You open the Lincoln Window.

>go west
Battlefield
The light you saw outside appears to be a man standing in the middle of field with a lantern. He is too far away to see you. The moonlight illuminates the headstones that surround him. He softly whistles a song that sounds vaguely familiar.

You can see a Lincoln Window and a soldier here.

I beg your pardon?

>look soldier
A man in a civil-war era war uniform. He holds a lantern and sadly scans the headstones all around him.

>talk soldier
That's not a verb I recognise.

>listen soldier
I only understood you as far as wanting to listen.

>listen to soldier
You hear nothing unexpected.

* * *

I beg your pardon?

>west
(first opening the ornate wooden door)

Lincoln Room
You enter the room, and again are met with the faint glow of candle light. The floor is wooden, and there is what looks like antique furniture all around. You walk forward, and notice a dim glow out of the corner of your eye. To the West is a window, it looks like there is some kind of light source outside.

You can see a Lincoln Window and an ornate wooden door here.

* * *

>go west
(first opening the ornate wooden door)

Lincoln Room
You enter the room, and again are met with the faint glow of candle light. The floor is wooden, and there is what looks like antique furniture all around. You walk forward, and notice a dim glow out of the corner of your eye. To the West is a window, it looks like there is some kind of light source outside.

You can see a Lincoln Window and an ornate wooden door here.

>go east
Keystone
You awake on a cold stone floor to the sound of doors slamming shut. You sit up, startled. The room is small, windowless, and its only sources of light are small candles, one in each corner. The light flickers softly. As you look closer at the walls, you notice each has a shadowy recess that looks vaguely like a door. North of you is the biggest recess, it looks like stone. To the south the is the smallest recess. To the east is a shimmering door that looks to be made of some kind of metal. To the west the the door is made of wood.

You can see an ornate wooden door, a shimmering metallic door and a heavy stone door here.

>go east
(first opening the shimmering metallic door)

Facility
The door shuts behind you and you hear a locking sound. The the room is remarkably bright, but you cannot see its source. The walls, floors, and ceiling are covered in a uniformly white, cloth-like material. In the middle of the room sits a rabbit in a cage, and next to it lies a white envelope.

You can see a shimmering metallic door, a cage (in which is a rabbit) and an envelope (in which are a key and a note) here.

>examine cage
In the cage is a rabbit.

>examine rabbit
A white rabbit with deep black eyes. It sits, motionless, directing its lifeless gaze toward you.

>examine envelope
A plain, white envelope. Your name is scrawled on the front in jagged, violent characters.

In the envelope are a key and a note.

>examine key
The key is brass, and the eye of the key is shaped like a wing.

>examine note
The note reads: A skull-sized kingdom awaits.

>examine cage
In the cage is a rabbit.

* * *

>west
(first opening the ornate wooden door)

Lincoln Room
You enter the room, and again are met with the faint glow of candle light. The floor is wooden, and there is what looks like antique furniture all around. You walk forward, and notice a dim glow out of the corner of your eye. To the West is a window, it looks like there is some kind of light source outside.

You can see a Lincoln Window and an ornate wooden door here.

>open window
You open the Lincoln Window.

>west
Battlefield
The light you saw outside appears to be a man standing in the middle of a field with a lantern. He is too far away to see you. The moonlight illuminates the headstones that surround him. He softly whistles a song that sounds vaguely familiar.

You can see a Lincoln Window and a soldier here.

>east
Lincoln Room
You enter the room, and again are met with the faint glow of candle light. The floor is wooden, and there is what looks like antique furniture all around. You walk forward, and notice a dim glow out of the corner of your eye. To the West is a window, it looks like there is some kind of light source outside.

You can see a Lincoln Window and an ornate wooden door here.

>east
Keystone
You awake on a cold stone floor to the sound of doors slamming shut. You sit up, startled. The room is small, windowless, and its only sources of light are small candles, one in each corner. The light flickers softly. As you look closer at the walls, you notice each has a shadowy recess that looks vaguely like a door. North of you is the biggest recess, south the smallest. To the east and west the doors look unremarkable.

You can see a heavy stone door and an ornate wooden door here.

>north
(first opening the heavy stone door)

The Instinct
The smell of death invades your nostrils. Frightened, you quickly scan what appears to be a cave. Straight ahead, lightning flashes and you can make out the mouth of the cave. Another flash, and you catch a glimpse of what seems to be a tiger devouring a carcass right at the entrance. You feel it shift its gaze to you. It charges straight for you and you turn to run, but the heavy stone door has shut behind you. The tiger leaps at you and you close your eyes, fearing the worst. The cave goes silent. Terrified, you open your eyes. Another flash of light, the tiger cannot be found. Another flash and crack of thunder and you can see the carcass still lies to the north at the mouth of the cave, and the blood is beginning to pool at your feet. It looks like it may be a person.

You can see a heavy stone door and a carcass here.

>look carcass
The man is bloodied and crumpled. He wears a shredded jacket and bloodstained pants. You lean down to feel if he is still breathing, and to your surprise, he mutters something under his breath. You lean closer. The muttering continues, and this time you can make out what he says. "…Wa--wallet."

>jacket
That's not a verb I recognise.

>search jacket
You find nothing of interest.

>look jacket
You see nothing special about the jacket.

The pocket contains nothing.

>examine jacket
You see nothing special about the jacket.

The pocket contains nothing.

* * *

I beg your pardon?

>go south
(first opening the small door)
It seems to be locked.

>go east
(first opening the shimmering metallic door)

Facility
The door shuts behind you and you hear a locking sound. The the room is remarkably bright, but you cannot see its source. The walls, floors, and ceiling are covered in a uniformly white, cloth-like material. In the middle of the room sits a rabbit in a cage, and next to it lies a white envelope.

You can see a shimmering metallic door, a cage (closed) and an envelope (in which are a key and a note) here.

* * *

>unlock small door
(with the key)
You unlock the small door.

>enter small door
(first opening the small door)

Annex
You can see a small door here.

>go south
Cathedral

* * *

>nort
That's not a verb I recognise.

>north
(first opening the heavy stone door)

The Instinct
The smell of death invades your nostrils. Frightened, you quickly scan what appears to be a cave. Straight ahead, lightning flashes and you can make out the mouth of the cave. Another flash, and you catch a glimpse of what seems to be a tiger devouring a carcass right at the entrance. You feel it shift its gaze to you. It charges straight for you and you turn to run, but the heavy stone door has shut behind you. The tiger leaps at you and you close your eyes, fearing the worst. The cave goes silent. Terrified, you open your eyes. Another flash of light, the tiger cannot be found. Another flash and crack of thunder and you can see the carcass still lies to the north at the mouth of the cave, and the blood is beginning to pool at your feet. It looks like it may be a person.

You can see a heavy stone door and a carcass here.

* * *

>carcass
That's not a verb I recognise.

>examine carcass
The man is bloodied and crumpled. He wears a shredded blazer and bloodstained pants. You lean down to feel if he is still breathing, and to your surprise, he mutters something under his breath. You lean closer. The muttering continues, and this time you can make out what he says. "…Wa--wallet.牯∽"

>examine blazer
You see nothing special about the blazer.

The blazer's pocket contains a wallet and a photograph.

>examine wallet
You see nothing special about the wallet.

>examine photograph
You see nothing special about the photograph.

>take wallet
That seems to belong to the carcass.

* * *

>go west
(first opening the ornate wooden door)

Lincoln Room
You enter the room, and again are met with the faint glow of candle light. The floor is wooden, and there is what looks like antique furniture all around. You walk forward, and notice a dim glow out of the corner of your eye. To the West is a window, it looks like there is some kind of light source outside.

You can see a Lincoln Window and an ornate wooden door here.

>go west
The window is shut: you'd break the glass.

>look through window
Through the window you make out the Battlefield. You think you might be able to climb through.

>climb through window
The window is shut: you'd break the glass.

>open window
You open the Lincoln Window.

>climb through window
Battlefield
The light you saw outside appears to be a man standing in the middle of a field with a lantern. He is too far away to see you. The moonlight illuminates the headstones that surround him. He softly whistles a song that sounds vaguely familiar.

You can see a Lincoln Window and a soldier here.

>talk soldier
That's not a verb I recognise.

>talk to soldier
That's not a verb I recognise.

>look soldier
A man in a civil-war era war uniform. He holds a lantern and sadly scans the headstones all around him.

>soldier
That's not a verb I recognise.

>search soldier
You find nothing of interest.

>a soldier
That's not a verb I recognise.

>search a soldier
You can't see any such thing.

* * *

>approach heavy stone door
That's not a verb I recognise.

>go north
(first opening the heavy stone door)

The Instinct
The smell of death invades your nostrils. Frightened, you quickly scan what appears to be a cave. Straight ahead, lightning flashes and you can make out the mouth of the cave. Another flash, and you catch a glimpse of what seems to be a tiger devouring a carcass right at the entrance. You feel it shift its gaze to you. It charges straight for you and you turn to run, but the heavy stone door has shut behind you. The tiger leaps at you and you close your eyes, fearing the worst. The cave goes silent. Terrified, you open your eyes. Another flash of light, the tiger cannot be found. Another flash, and crack of thunder and you can see the carcass still lies to the north at the mouth of the cave, and the blood is beginning to pool at your feet.

You can see a heavy stone door here.

>go south
Keystone
You awake on a cold stone floor to the sound of doors slamming shut. You sit up, startled. The room is small, windowless, and its only sources of light are small candles, one in each corner. The light flickers softly. As you look closer at the walls, you notice each has a shadowy recess that looks vaguely like a door. North of you is the biggest recess, south the smallest. To the east and west the doors look unremarkable.

You can see a heavy stone door and an ornate wooden door here.

>go west
(first opening the ornate wooden door)

Lincoln Room
You enter the room, and again are met with the faint glow of candle light. The floor is wooden, and there is what looks like antique furniture all around. You walk forward, and notice a dim glow out of the corner of your eye. To the West is a window, it looks like there is some kind of light source outside.

You can also see an ornate wooden door here.

>go west
The window is shut: you'd break the glass.

>search window
Through the window you make out The Battlefield.

>climb through window
I don't think much is to be achieved by that.

>open window
You open the Lincoln Window.

>climb through window
I don't think much is to be achieved by that.

I beg your pardon?

>jump
You jump on the spot, fruitlessly.

>climb window
I don't think much is to be achieved by that.

>search window
Through the window you make out The Battlefield.

* * *

I beg your pardon?

>look through window
Through the window you make out The Battlefield.

>e
Keystone
You awake on a cold stone floor to the sound of doors slamming shut. You sit up, startled. The room is small, windowless, and its only sources of light are small candles, one in each corner. The light flickers softly. As you look closer at the walls, you notice each has a shadowy recess that looks vaguely like a door. North of you is the biggest recess, south the smallest. To the east and west the doors look unremarkable.

You can see an ornate wooden door and a heavy stone door here.

I beg your pardon?

>open ornate wooden door
That's already open.

>go through ornate wooden door
Lincoln Room
You enter the room, and again are met with the faint glow of candle light. The floor is wooden, and there is what looks like antique furniture all around. You walk forward, and notice a dim glow out of the corner of your eye. To the West is a window, it looks like there is some kind of light source outside.

You can also see an ornate wooden door here.

>open window
That's already open.

>search window
Through the window you make out The Battlefield.

>climb through
What do you want to climb through?

>climb through Lincoln Window
I don't think much is to be achieved by that.

>climb through The Lincoln Window
I don't think much is to be achieved by that.

>climb through window
I don't think much is to be achieved by that.

>look outside window
I only understood you as far as wanting to look outside.

>look window
You see nothing special about the Lincoln Window.

>go west
The Battlefield
The light you saw outside appears to be a man standing in the middle of field with a lantern. He is too far away to see you. The moonlight illuminates the headstones that surround him. He softly whistles a song that sounds vaguely familiar.

You enter the room, and again are met with the faint glow of candle light. The floor is wooden, and there is what looks like antique furniture all around. You walk forward, and notice a dim glow out of the corner of your eye. To the West is a window, it looks like there is some kind of light source outside.

>e
Lincoln Room
You enter the room, and again are met with the faint glow of candle light. The floor is wooden, and there is what looks like antique furniture all around. You walk forward, and notice a dim glow out of the corner of your eye. To the West is a window, it looks like there is some kind of light source outside.

You can also see an ornate wooden door here.

>go west
The Battlefield
The light you saw outside appears to be a man standing in the middle of field with a lantern. He is too far away to see you. The moonlight illuminates the headstones that surround him. He softly whistles a song that sounds vaguely familiar.

You enter the room, and again are met with the faint glow of candle light. The floor is wooden, and there is what looks like antique furniture all around. You walk forward, and notice a dim glow out of the corner of your eye. To the West is a window, it looks like there is some kind of light source outside.

* * *

>enter small door
(first opening the small door)
It seems to be locked.

>go east
(first opening the shimmering metallic door)

Facility
The door shuts behind you and you hear a locking sound. The the room is remarkably bright, but you cannot see its source. The walls, floors, and ceiling are covered in a uniformly white, cloth-like material. In the middle of the room sits a rabbit in a cage, and next to it lies a white envelope.

You can see a shimmering metallic door, a cage (closed) and an envelope (in which are a key and a note) here.

* * *

>take key
Taken.

>unlock cage with key
You unlock the cage.

>return
That's not a verb I recognise.

>go west
Keystone
You awake on a cold stone floor to the sound of doors slamming shut. You sit up, startled. The room is small, windowless, and its only sources of light are small candles, one in each corner. The light flickers softly. As you look closer at the walls, you notice each has a shadowy recess that looks vaguely like a door. North of you is the biggest recess, it looks like stone. To the south the is the smallest recess. To the east is a shimmering door that looks to be made of some kind of metal. To the west the the door is made of wood.

You can see a shimmering metallic door, a heavy stone door, an ornate wooden door and a small door here.

>go north
(first opening the heavy stone door)

The Instinct
The smell of death invades your nostrils. Frightened, you quickly scan what appears to be a cave. Straight ahead, lightning flashes and you can make out the mouth of the cave. Another flash, and you catch a glimpse of what seems to be a tiger devouring a carcass right at the entrance. You feel it shift its gaze to you. It charges straight for you and you turn to run, but the heavy stone door has shut behind you. The tiger leaps at you and you close your eyes, fearing the worst. The cave goes silent. Terrified, you open your eyes. Another flash of light, the tiger cannot be found. Another flash and crack of thunder and you can see the carcass still lies to the north at the mouth of the cave, and the blood is beginning to pool at your feet. It looks like it may be a person.

You can see a heavy stone door and a carcass here.

>go south
Keystone
You awake on a cold stone floor to the sound of doors slamming shut. You sit up, startled. The room is small, windowless, and its only sources of light are small candles, one in each corner. The light flickers softly. As you look closer at the walls, you notice each has a shadowy recess that looks vaguely like a door. North of you is the biggest recess, it looks like stone. To the south the is the smallest recess. To the east is a shimmering door that looks to be made of some kind of metal. To the west the the door is made of wood.

You can see a heavy stone door, an ornate wooden door, a shimmering metallic door and a small door here.

>go east
Facility
The door shuts behind you and you hear a locking sound. The the room is remarkably bright, but you cannot see its source. The walls, floors, and ceiling are covered in a uniformly white, cloth-like material. In the middle of the room sits a rabbit in a cage, and next to it lies a white envelope.

You can see a shimmering metallic door, a cage (closed) and an envelope (in which is a note) here.

>go west
Keystone
You awake on a cold stone floor to the sound of doors slamming shut. You sit up, startled. The room is small, windowless, and its only sources of light are small candles, one in each corner. The light flickers softly. As you look closer at the walls, you notice each has a shadowy recess that looks vaguely like a door. North of you is the biggest recess, it looks like stone. To the south the is the smallest recess. To the east is a shimmering door that looks to be made of some kind of metal. To the west the the door is made of wood.

You can see a shimmering metallic door, a heavy stone door, an ornate wooden door and a small door here.

You see a key in the middle of the floor that you hadn't seen before…in t

>go west
(first opening the ornate wooden door)

Lincoln Room
You enter the room, and again are met with the faint glow of candle light. The floor is wooden, and there is what looks like antique furniture all around. You walk forward, and notice a dim glow out of the corner of your eye. To the West is a window, it looks like there is some kind of light source outside.

You can see a Lincoln Window and an ornate wooden door here.

>go east
Keystone
You awake on a cold stone floor to the sound of doors slamming shut. You sit up, startled. The room is small, windowless, and its only sources of light are small candles, one in each corner. The light flickers softly. As you look closer at the walls, you notice each has a shadowy recess that looks vaguely like a door. North of you is the biggest recess, it looks like stone. To the south the is the smallest recess. To the east is a shimmering door that looks to be made of some kind of metal. To the west the the door is made of wood.

You can see an ornate wooden door, a shimmering metallic door, a heavy stone door and a small door here.

* * *

>go north
(first opening the heavy stone door)

The Instinct
The smell of death invades your nostrils. Frightened, you quickly scan what appears to be a cave. Straight ahead, lightning flashes and you can make out the mouth of the cave. Another flash, and you catch a glimpse of what seems to be a tiger devouring a carcass right at the entrance. You feel it shift its gaze to you. It charges straight for you and you turn to run, but the heavy stone door has shut behind you. The tiger leaps at you and you close your eyes, fearing the worst. The cave goes silent. Terrified, you open your eyes. Another flash of light, the tiger cannot be found. Another flash and crack of thunder and you can see the carcass still lies to the north at the mouth of the cave, and the blood is beginning to pool at your feet. It looks like it may be a person.

You can see a heavy stone door and a carcass here.

>go south
Keystone
You awake on a cold stone floor to the sound of doors slamming shut. You sit up, startled. The room is small, windowless, and its only sources of light are small candles, one in each corner. The light flickers softly. As you look closer at the walls, you notice each has a shadowy recess that looks vaguely like a door. North of you is the biggest recess, it looks like stone. To the south the is the smallest recess. To the east is a shimmering door that looks to be made of some kind of metal. To the west the the door is made of wood.

You can see a heavy stone door, an ornate wooden door, a small door and a shimmering metallic door here.

>go east
(first opening the shimmering metallic door)

Facility
The door shuts behind you and you hear a locking sound. The the room is remarkably bright, but you cannot see its source. The walls, floors, and ceiling are covered in a uniformly white, cloth-like material. In the middle of the room sits a rabbit in a cage, and next to it lies a white envelope.

You can see a shimmering metallic door, a cage (closed) and an envelope (in which are a key and a note) here.

>go west
Keystone
You awake on a cold stone floor to the sound of doors slamming shut. You sit up, startled. The room is small, windowless, and its only sources of light are small candles, one in each corner. The light flickers softly. As you look closer at the walls, you notice each has a shadowy recess that looks vaguely like a door. North of you is the biggest recess, it looks like stone. To the south the is the smallest recess. To the east is a shimmering door that looks to be made of some kind of metal. To the west the the door is made of wood.

You can see a shimmering metallic door, a heavy stone door, an ornate wooden door and a small door here.

>go west
(first opening the ornate wooden door)

Lincoln Room
You enter the room, and again are met with the faint glow of candle light. The floor is wooden, and there is what looks like antique furniture all around. You walk forward, and notice a dim glow out of the corner of your eye. To the West is a window, it looks like there is some kind of light source outside.

You can see a Lincoln Window and an ornate wooden door here.

* * *

>open small door
It seems to be locked.

>find the key
That's not a verb I recognise.

>take key
You can't see any such thing.

* * *

>go south
(first opening the small door)
It seems to be locked.

>go east
(first opening the shimmering metallic door)

Facility
The door shuts behind you and you hear a locking sound. The the room is remarkably bright, but you cannot see its source. The walls, floors, and ceiling are covered in a uniformly white, cloth-like material. In the middle of the room sits a rabbit in a cage, and next to it lies a white envelope.

You can see a shimmering metallic door, a cage (closed) and an envelope (in which are a key and a note) here.

[Your score has just gone up by one point.]

>take key
Taken.

* * *

>go south
(first opening the small door)
It seems to be locked.

>unlock door key
Which do you mean, the shimmering metallic door, the heavy stone door, the ornate wooden door or the small door?

>unlock small door with key
You unlock the small door.

>go south
(first opening the small door)

Annex
You can see a small door here.

>go south
Cathedral
The body of the Cathedral is imposing. The stained glass windows shoot their colored rays across the floors, and smoke rises from the candles on the alter. The smell of incense is strong. To the east is the Masoleum.

[Your score has just gone up by one point.]

>go east
Masoleum

    *** You have won ***

In that game you scored 3 out of a possible 0, in 9 turns.

Would you like to RESTART, RESTORE a saved game, QUIT or UNDO the last command?

* * *

>east
(first opening the shimmering metallic door)

Facility
The door shuts behind you and you hear a locking sound. The the room is remarkably bright, but you cannot see its source. The walls, floors, and ceiling are covered in a uniformly white, cloth-like material. In the middle of the room sits a rabbit in a cage, and next to it lies a white envelope.

You can see a shimmering metallic door, a cage (closed) and an envelope (in which are a key and a note) here.

>examine cage
You see nothing special about the cage.

I beg your pardon?

>examine envelope
A plain, white envelope. Your name is scrawled on the front in jagged, violent characters.

In the envelope are a key and a note.

* * *

>examine key
The key is brass, and the eye of the key is shaped like a wing.

>take key
Taken.

>use key on cage
That's not a verb I recognise.

>unlock cage with key
You unlock the cage.

* * *

>enter shimmering metallic door
(first opening the shimmering metallic door)

Facility
The door shuts behind you and you hear a locking sound. The the room is remarkably bright, but you cannot see its source. The walls, floors, and ceiling are covered in a uniformly white, cloth-like material. In the middle of the room sits a rabbit in a cage, and next to it lies a white envelope.

You can see a shimmering metallic door here.

>examine envelope
You can't see any such thing.